00000000000000000000000000000000000000000000000000
00000000000000000000000000000000000000000000000000
00000000522222222222260000000000000000000000000000
000000003c1111111111b40000000000000000000000000000
00000000340000000000340000000000000000000000000000
00000000340000000000340000000000000000000000000000
00000000340000000000340000000000000000000000000000
22222222940000000000340000000000000000000000000000
11111111180000000000340000000000000000000000000000
00000000000000000000340000000000000000000000000000
00000000000000000000340000000000000000000000000000
00000000000000000000340000000000000005222222222222
00000000000000000000340000000000000003c11111111111
00000000000000000000340000000000000003400000000000
00000000000000000000340000000000000003400000000000
00000000000000000000340000000000000003400000000000
00000000000000000000340000000000000003400000000000
000000000000000000003a2222222222222229400000000000
00000000000000000000711111111111111111800000000000
00000000000000000000000000000000000000000000000000
